11111111
1PC11001
10000001
10000001
100C0001
10CCCC01
11110111
100000E1
11111111
