11111111111111111
10EP0000000000001
10000000000000001
1000000000000C001
10000000000000001
10011111111000001
1000000C000000001
10000000000000001
11111111111111111
