11111111111111111
1PCE0000000000001
10000000000000001
10000000000000001
10000000000000001
10011111111000001
10000000000000001
10000000000000001
11111111111111111