11111111111111111
1P0E0000000E00001
10000000000000001
1000000C000C00001
1000000C000000001
10011111111000001
10000000000E00001
10000000000000001
11111111111111111